111111111111111111
1CCCCC1CCCCCCCCCC1
1CCCCC1CCCCCC1CEC1
1P111C111111CCCCC1
1CCCCCCCCCCCCCC1C1
111111111111111111
