11111111111111111111111111111111111111111111111111111111111111111111111111111111111
1P1CCC1CCC1CCC1111CCC11C111111111111111111111111111111111111111111111111111CCCC1C11
1C1C1C1C1C1C1C111CC1C1CCC111CCCCCCCCCCCC11111111111111111111111111111111111C1111C11
1CCC1C1C1C1C1C111C11C1C1CC11C111111111CCCCCCCC11111111111111111111111111111C1111CC1
11111C1C1C1C1C111C1CC1C11C11C111CCC111C111111CCCCCCCCCCCCCCCCCCCCCCCCCCCCCCCC1111C1
11111C1C1C1C1C111C1C11C11C11C111C1CCC1C11111111111111111111111111C1111111111CC111C1
1CCCCC1C1C1C1C11CC1C11C11C11C111C11CCCCC1111111111111111111111111C11111111111C111C1
1C11111C1C1C1C11C11C11C11C1CC111C11C1CCC11111111111111111111111111C1111111111CCCCC1
1C1CCCCC1C1C1C11C11C11C11C1C1111C11C11CC11111111111111111111111111C11111111CCC11111
1C1C11111C1C1C1CC11C11C11C1C1111C11C111CCCCCCCCCCCCCCCCCCCCCCCCCCCCCCCCCCCCC1111111
1C1C1CCCCC1C1C1C111C1CC11C1CC111C11C111C1111111111111111111111111111111111111111111
1C1C1C1111CC1C1C11CCCC111C11C111C11C111C1111111111111111111111111111111111111111111
1C1C1C1111C11C1C11C1C1111C11C111CCC1111C111111111111CCCCCCCCCCCCCCCCCCCCCCCCCCCCC11
1C1C1C1111C1CC1C11C1C1111C11C1111C11111C111CCCCCCCCCC111111111111111111111111111C11
1C1C1C1111C1CC1C11C1CCC11C11CC111CC1111C11CC111111111111111111111111111111111111C11
1C1C1CCCC1C1C11C11CC11C11C111C1111C1111C1CC111CCCCCCCCCCCCCCCCCCCCCCCCCCCCC11111C11
1C1C1111C1C1C11CC11CC1C11C111C1111C111CCCC11CCC111111111111111111111111111CCCC11C11
1C1CCCC1C1C1C111CC11C1C11C111C1111CC11C1C111C111CCC11111111111111111111111111CCCC11
1C1111C1C1C1CC111C11C1C11C111C11111C11C1C111C11CC1CCCCCCCCCCCCCCCCCCCCCCCCCCC111111
1CCCC1C1C1C11C111CC1C1C11C111C11111C11C1CC11C11C1111111111111111111111111111C111111
1111CCCCCCCCCCCCCCCCCCC11C111C11111CC1C11C11C11C1111111CCCCCCCCCCCC111111111CC11111
1CCCC1C1C1C1C11111C1CCCCCCCCCCCCCCCCCCCCCCCCCCCCCCCCCCCCCCCCCCCCCCCCCCCCCCCCCCCC111
1C1111C1C1C1C1111CC1C1C11C111C1111C11CC11C11CC11C111CC111CCCCCCCCC111111CC111CCCC11
1CCCC1C1C1C1C1111C11C1C11C111C1111C11CC11C111C11C1111C111CC111111CCC11111CC11111C11
1111C1C1C1C1C111CC11C1C11C111C1111C11CC11CC11C11CC111CC111C11111111CC11111CCC111C11
1111C1C1C1C1C111C111C1C11C111C1111C111C111CC1CC11CCC11CC11C111111111CCC11111CCCCC11
1CCCC1C1C1C1C111C11CC1C11C111CC11C1111CC111CC1CC111CC11CC1CC111CCC1111CCC1111111111
1C111CC1C1C1C111C11C11C11C1111C11C1111CC1111CC1CC111C111C11C111C1CCC1111CC111111111
1C1CCC1CC1C1C111C11C11C11CC111CC1C1111CC11111CC1CC11C111CC1C111C111CCC111CCC1111111
1C1C11CC1CC1C111C1CC1CC111C1111CCC1111CC111111C11C11CC111C1CC11C11111CC1111CCC11111
1C1C1CC1CC11C111C1C11C1111C11111CCCCC1CC111111C11C111C111C11CCCC111111CC11111C11111
1C1C1C1CC111C111C1C11C1111C111111111C1CC111111C11C111C111C111CC111CCC111CC111CC1111
1C1C1C1C11CCC111C1C11C1111C1111111CCC11C111111C11C111C111C111CC111C1CC111CCC11C1111
1C1C1C1C11C1111CC1C11C1111C1111111C111CC11111CC11C11CC111C111CCC11C11C11111CCCC1111
1C1C1C1C1CC111CC11C11C1111C11111CCC111CC11111C111C11C1111C111C1C11CC1C11111C1111111
1C1CCCCCCCCCCCCCCCCCCCCCCCC1111CC11CCCCCCCCCCCCCCCCCCCCCCCCCCCCC111C1C1111CCCCCCCC1
1C1C1C1C1C1111C1CC1CCC111CCCCCCCCCCCCC1C11111C111C11C111CC11CC1CC11C1CC111CCCCCCCC1
1C1C1C1C1C1111C1C11C111111C111C11111C11C11111C111C11C11CC1111C11C11C11CC11CCCCCCCC1
1C1C1C1C1C1111C1C11C111111CC1CC11111C1CC11111C111C11C11C11111C11C11C111CC1CCCCCCCC1
1C1C1C1C1C1111C1C11C1111111CCC111111CCC111111C111C11C11C1111CC11CC1C1111CCCCCCCCCC1
1C1C1C1C1CCCCCC1C11C111111111111111111CCCCCCCC111CCCC11CCCCCC1111CCC11111CCCCCCCCC1
1CCC1CCC111CC111CCCC111111111111111111111111111111111111111111111111111111CCCCCCCE1
11111111111111111111111111111111111111111111111111111111111111111111111111111111111
